NO /Users/skasmi/Cub3D/xpm_files/TECH_1A_1.xpm
SO /Users/skasmi/Cub3D/xpm_files/TECH_1A_1.xpm
WE /Users/skasmi/Cub3D/xpm_files/TECH_1A_1.xpm
EA /Users/skasmi/Cub3D/xpm_files/TECH_1A_1.xpm
F 0,0,0
C 255,255,255




1111111111111111111111111
1000000000110000S00000001
1011000001110000000000001
1001000000000000000000001
111111111011000001110000000000001
100000000011000001110111111111111
11110111111111011100000010001
1111011111111101110101001000
11000000110101011100000010001
10000000000000001100000010001
10000000000000001101010010001
1100000111010101111101111000111
11110111 1110101 101111010001
11111111 1111111 111111111111
