NO
C     250   ,   30  ,   0
SO




      WE
F         255     ,      100    ,    0
EA






1111111111111111111111
1000000000000000000001
1000000000000000000001
100000000S000010000001
1000000000000000000001
1000000000000000011101
1000000000000000000001
1111111111111111111111