NO
SO
WE
EA
C     78   ,   90  ,   8
F         135    ,      106    ,    235
F    78,90,8
C 	35,206,235



1111111111111111111111111
100100000000N000000000001
1000000000000000000000001
1000000000000000000000001
1000000000000000000000001
1000000000000000000000001
1000000000000000000000001
1111111110000000000000001
1000000000000000000000001
11111111100000000000000001111
10000000000001000000000000001
10000000000000100000000000001
10000000000000000000000000001
11000000110101011100000010001
111111111000000011000000100011111111111111111111111111
        1000000000110000000000001100000000011000001111
        1000001111111111111111001100000000011000001111 
        1000001              1000000000000000111000000111111
111111111000001              110000001000110000000001100000111
100000000000001              1010101001000110000000001100000111
100000000000001              111100000000001111000000000110001
100000000000001              11110111111111111111111111111111
100000000000011              110000001000110111
10000000000000111111111111111100000000011000001111111111
10000000000000001101010010001100000000011000001110100001
10000000000000001101010011111111111111011000010000111111
10000000000001011101010011        111111111111111101
11000000000001011100000011     11110000000011000001111111111111111
11111111100000001100000011     11100000000011000001110111111111111
        100000000000000001     111111100000000011000001110111111111111
        100000000011000001     100001100000000011000001110111111111111
        100000000111000001     100001100000000011000001110111111111111
        100000000000000001     111111111111111111111111111100000000001
11111111100000000111000001                                100111100011111111111111111
10000000000000000111011111                                111111100000000011000001110111
11110111100001011100000011                                1110000000001100000111000000001111
11110111100001011101010011                                10000000000000000001100000000000011
11000000100001011100000011                                10000000000011000001110111111111111
10000000000000001100000011                                1100001110111111111111100001111111
10000000000000011111111111                                10000000000011000111111111111
1000000000000001                                          111111111111111111           
1000000000000001111111111111111111111111111111111111111111111111111111111111
1111111111111111