         NO          /Users/skasmi/Cub3D/xpm_files/test.xpm
         C          204,255,255
         
   SO          /Users/skasmi/Cub3D/xpm_files/test.xpm
         WE          /Users/skasmi/Cub3D/xpm_files/test.xpm
         F         190,190,190
         EA                       /Users/skasmi/Cub3D/xpm_files/test.xpm



    1111111
    1000N01
    1000001 
11111111111 