         NO          /Users/skasmi/saife2/xpm_files/TECH_1A_1.xpm
         
         F     0,0,0
         C     255 , 1, 255
   SO          /Users/skasmi/saife2/xpm_files/TECH_2A_1.xpm
         WE          /Users/skasmi/saife2/xpm_files/TECH_3A_1.xpm
         EA                       /Users/skasmi/saife2/xpm_files/TECH_4A_1.xpm




11111111111111111111111111111111
1100000000000S000000000000000001
10000000000000000000000000000001
10000000000000000000000000000001
10000000000000000000000000000001
10000000000000000000000000000001
10000000000000000000000000000001
10000000000000000000000000000001
10000000000000000000000000000001
10000000000000000000000000000001
10000000000000000000000000000001
10000000000000000000000000000001
10000000000000010000000000000001
10000000000000000000000000000001
10000000000000000000000000000001
10000000000000000000000000000001
10000000000000000000000000000001
10000000000000000000000000000001
10000000000000000000000000000001
10000000000000000000000000000001
10000000000000000000000000000001
10000000000000000000000000000001
10000000000000000000000000000001
10000000000000000000000000000001
11111111111111111111111111111111