NO /home/elder-griffin/Desktop/Projects/cub3d/xpm_files/TECH_1A_1.xpm
SO /home/elder-griffin/Desktop/Projects/cub3d/xpm_files/TECH_1A_1.xpm
WE /home/elder-griffin/Desktop/Projects/cub3d/xpm_files/TECH_1A_1.xpm
EA /home/elder-griffin/Desktop/Projects/cub3d/xpm_files/TECH_1A_1.xpm
F  255,255,255
C  50,100,255

11111111111111111111111111111111
1100000000000S000000000000000001
10000000000000000000000000000001
10000000000000000000000000000001
10000000000000000000000000000001
10000000000000000000000000000001
10000000000000000000000000000001
10000000000000000000000000000001
11111110000000000000000011111111
10000000000000000000000000000001
10000000000000000000000000000001
10000000000000000000000000000001
10000000000000000000000000000001
10000000000000010000000000000001
10000000000000000000000000000001
10000000000000000000000000000001
10000000000000000000000000000001
10000000000000000000000000000001
10000000000000000000000000000001
10000000000000000000000000000001
10000000000000000000000000000001
10000000000000000000000000000001
10000000000000000000000000000001
10000000000000000000000000000001
10000000000000010000000000000001
11111111111111111111111111111111
