         NO          /Users/skasmi/Cub3D/xpm_files/test.xpm
         C          204,255,255
         
   SO          /Users/skasmi/Cub3D/xpm_files/test.xpm
         WE          /Users/skasmi/Cub3D/xpm_files/test.xpm
         F         190,190,190
         EA                       /Users/skasmi/Cub3D/xpm_files/test.xpm



11111111111111111111111111111111
100000000000N0000000000000000001
10000000000000000000000000000001
10000000000000000000000000000001
10000000000000000000000000000001
10000000000000000000000000000001
10000000000000000000000000000001
10000000000000000000000000000001
10000000000000000000000000000001
10000000000000000000000000000001
10000000000000000000000000000001
10000000000000000000000000000001
10000000000000010000000000000001
10000000000000000000000000000001
10000000000000000000000000000001
10000000000000000000000000000001
10000000000000000000000000000001
10000000000000000000000000000001
10000000000000000000000000000001
10000000000000000000000000000001
10000000000000000000000000000001
10000000000000000000000000000001
10000000000000000000000000000001
10000000000000000000000000000001
11111111111111111111111111111111